111111111111111111111111111
100000000000000000000000001
101000000101011100000000001
1001000E0010001000000000001
101000000101010100000000001
100000000000000000000000001
111111111111111111111111111