111111111111
100000000011
101100000111
1001000N00001111111
1111111110110000001
1000000000111111111
11111111 111111