111111111111
100000110001
100011100001
100000000101
100000000101
10000N000101
111111111111