1111111111111111111111111
1000000000110000000000001
1011000001110000000N00001
1001000000000000000000001
1111111110110000011100001
1111111111111111111111111