111111111111
100000010001
100000110001
100011100001
100000000101
111111111111