NO ./xpm/north.xpm      
SO ./xpm/south.xpm        
WE ./xpm/west.xpm
EA ./xpm/east.xpm

F 83,104,120      
C        242,247,250    

111111111111111111111111
1000000000110000000000001
11011000001110000000000001
100100000010101S00000000111111111
111111111001010001110000000000001
100000111110000001110111111111111
1111011 111111011100000010001
11110111111111011101010010001
11000000110101011100000010001
10000000000000001100011110001
10000000000000001101011010001
110000011101010111110111100111
11110111 1110101 101111010001
11111111 1111111 111111111111