1111111111111111111111111
1000000000000000000000001
1010000001110000000000001
1001000000000000000000001
1010E00001110000000100001
1000000000000000000000001
1011000001110000000100001
1011000000001000000000001
1111111111110000011100001
1111111111111111111111111