111111111111111111111111111111111
100000110000000000000000000000011
1000111000000000000R0000000000001
1000000001000000000R0000000000001
1000000001000000000R0000000000001
1000000001000000000R0000000000001
1000000001000000000R0000N00000001
1000000001000000000R0000000000001
100000000100000000000000000000001
100000000100000000000000000000001
111111111111111111111111111111111