111111111111111111111111111111111
100000110000000000000000000000011
10001110000000000000000000000000 1
100000000100000000000000000000001
100000000100000000000000000000001
10000000010000000000000000000000 1
100000000100000000000000N00000001
100000000100000000000000000000001
100000000100000000000000000000001
100000000100000000000000000000001
111111111111111111111111111111111