111111111111
100000010001
10S000110001
100011100001
100000000101
111111111111