C      242,247, 250    
NO        ./xpm/north.xpm      
EA ./xpm/east.xpm      

       WE       ./xpm/west.xpm
F 83,      104,120      

SO                    ./xpm/south.xpm       


111111111111111111111111
1000000000110010000000001
11011000001110000000000001
 100100000010101N00000011111111
11111111100101000111000000000001
1000001111100000011101111111111
111101 111111011100000010001
11110111111111011101010010001
11000000110101011100000010001
1000000000000000110001111001
10000000000000001101011010001
10000011101010111110111100111
11110111 1110101 101111010001
11111111 1111111 111111111111