1111111111111111111111111
1000000000110000000000001
1011000001110000000000001
1001000000000000000000001
1111111110110000011100001
1000000000110000011101101
1111011111111101110000001
1111011111111101110101001
1100000011000001110000001
10000000000N0000110000001
1000000000000000110101001
1100000111010101111101101
11110111 1110101 10111101
11111111 1111111 11111101